%%%%%%%%%%%%%%
%. . . . . % %
%          % %
%. . . . . %G%
%          % %
%. . . . . % %
%          % %
%. . . . . % %
%     P    %G%
%. . . . . % %
%          % %
%. . . . . % %
%          % %
%%%%%%%%%%%%%%
