%%%%%%%%%%%%%%%%%%%%
%.           . %   %
% %%.%%.%%.%%.%% % %
%                % %
%%%%%%%%%%%%%%%%%% %
%Po. .             %
%%%%%%%%%%%%%%%%%%%%