%%%%%%%%%%%%%%%%%%%%%%%%%%%%%%%
%.%     ....%% G %%%%%%   o%%.%
%.%o%%%%%%%.%%%%%%%     %%%%%.%
% %%%.%%%%%.%%%%%%%.%%%.%.%%%.%
%    ..........Po...%.........%
%%%%%%%%%%%%%%%%%%%%%%%%%%%%%%%
