%%%%%%%%%%
%.      P%
%%%%%%%%%%
