%%%%%%%%%
%..   ..%
%%%%.%% %
%   P   %
%.%% %%.%
%.%.   .%
%%%%%%%%%
