%%%%%%%%%
% G %...%
%%%%%%% %
%Po     %
%.%%.%%.%
%.%%....%
%%%%%%%%%
